****G****G*********************
**** **** *********************
** *       *                 **
** * ******* *************** **
** *            *            **
** ************************* **
**              *            **
** ****** ******* *************
** *G                      	 **
** *********** ************* **
** *       *         *       **
** ******* ********* * ********
**           *       *       **
******* ***********************
*******S***********************