*********G*******************
* *       *                 *
* * ******* *************** *
* *            *            *
* ************************* *
*              *            *
* ****** ******* ************
* *                         *
* ************************* *
* *       *         *       *
* ******* ********* *********
*                           *
****** ******* ****** ***** *
*            *      *     * *
******S**********************