*********G*******************
* *       *                 *
* * ******* *************** *
* *            *            *
* ************************* *
*              *            *
* ****** ******* ************
* *            *            *
* *********** ************* *
* *       *         *       *
* ******* ********* * *******
*           *       *       *
****** ******* ************ *
*            *              *
******S**********************